############################
#............##............#
#.####.#####.##.#####.####.#
#.####.#####.##.#####.####.#
#.####.#####.##.#####.####.#
#..........................#
#.####.##.########.##.####.#
#......##.########.##......#
######.##....##....##.######
     #.##### ## #####.#     
     #.##          ##.#     
     #.##          ##.#     
######.##          ##.######
      .            .        
######.##          ##.######
     #.##          ##.#     
     #.##          ##.#     
     #.##  ######  ##.#     
######.##....##....##.######
#............##............#
#.####.#####.##.#####.####.#
#...##.......##.......##...#
###.##.##..........##.##.###
###.##.##.########.##.##.###
#......##....##....##......#
#.##########.##.##########.#
#..........................#
############################