#############################################################################
#                    #                     #               #                #
#  X                 #          ****       #               #                #
#                    #         ******                      #                #
#                    #          ****       #               #                #
#                    #            A        #               #                #
#                    #                     ########## ######                #
#                    #                     #               #                #
#                    #                     #               #                #
#                                          #                                #
#                    #                     #               #                #
########################################################################    #
#                                                                           #
#    ########################################################################
#                    #                     #               #                #
#                    #                     #               #                E
#                    #                                     #                #
#                    #                     #               #                #
#                    #            A        #               #                #
#                    #                     ########## ######                #
#                    #                     #               #                #
#                    #                     #               #                #
#                                          #                                #
#                    #                     #               #                #
#############################################################################
#############################################################################
#                    #                     #               #                #
#  X                 #          ****       #               #                #
#                    #         ******                      #                #
#                    #          ****       #               #                #
#                    #            A        #               #                #
#                    #                     ########## ######                #
#                    #                     #               #                #
#                    #                     #               #                #
#                                          #                                #
#                    #                     #               #                #
########################################################################    #
#                                                                           #
#    ########################################################################
#                    #                     #               #                #
#                    #                     #               #                E
#                    #                                     #                #
#                    #                     #               #                #
#                    #            A        #               #                #
#                    #                     ########## ######                #
#                    #                     #               #                #
#                    #                     #               #                #
#                                          #                                #
#                    #                     #               #                #
#############################################################################