##########################################################################################################################################################
#                    #                     #               #                ##                    #                     #               #                #
#                    #          ****       #               #                                      #          ****       #               #                #
#  X   AA                      ******                                                             #         ******                      #                #
#                    #          ****       #               #                ##                    #          ****       #               #                #
#                    #            A        #               #                ##                    #            A        #               #                #
#                    #                     ########## ######                ##                    #                     ########## ######                #
#                    #                     #               #                ##                    #                     #               #                #
#                    #                     #               #                ##                    #                     #               #                #
#                                          #                                ##                                          #                                #
#                    #                     #               #                ##                    #                     #               #                #
#    ###################################################################    ##    ###################################################################    #
#                                                                           ##                                                                           #
#    #####################################################################################################################################################
#                    #                     #               #                #
#                    #                     #               #                E
#                    #                                     #                #
#                    #                     #               #                #
#                    #            A        #               #                #
#                    #                     ########## ######                #
#                    #                     #               #                #
#                    #                     #               #                #
#                                          #                                #
#                    #                     #               #                #
#    ########################################################################
#    ########################################################################
#                    #                     #               #                #
#                    #          ****       #               #                #
#                    #         ******                      #                #
#                    #          ****       #               #                #
#                    #            A        #               #                #
#                    #                     ########## ######                #
#                    #                     #               #                #
#                    #                     #               #                #
#                                          #                                #
#                    #                     #               #                #
#    ###################################################################    #
#                                                                           #
#    ########################################################################
#                    #                     #               #                #
#                    #                     #               #                E
#                    #                                     #                #
#                    #                     #               #                #
#                    #            A        #               #                #
#                    #                     ########## ######                #
#                    #                     #               #                #
#                    #                     #               #                #
#                                          #                                #
#                    #                     #               #                #
#############################################################################